=================.~~~~AAAAAA^^AAAAAAAA^^^^^AAAAAAAA^^^^^^^^^^^AAAAAAAAA^^^^A^^^AAAAAAAAAA^^^^^^^^^^^
======.==========..~~~~~AAAAAAAAAAAAAAA^^AAAAAAAAAAAA^^^^^AAAAAAAAAAAAAAAA^^^AAAAAAAAAAAAAA^^^^^^^^^
=====.&.==========...~~~~AAAAAAAAAAAAAAAAAAAAAAAAAAAAAA^^AAAAAAAAAAAAAAAA^^^AAAAAAAAAAAAAAAAA^^^^^AA
=====.A&.=========.....~~~AAAAAAAAAAAAAAAAAAAAAAAAAAAAAAAAAAAAAAAAAAAAAAAAAAAAAAAAAAAAAAAAAAAAA^^^^A
====.&AA...=..=====.....&.~~~AA~~~AAAAAAAAAA~~~~AAAAAAAAAAAAAAA~~A~AAAAAAAAAAAAAAAAAAAAAAAAAAAAA^^^A
===.&&^~&.&...=========..&&~A^A~~~~AAAAAAAA~~~~~~AAAAAAAAAAA~~~~~~~~AAAAAAAAAAAAAAAAAAAAAAAAAAAAA^^A
===.&^^A~&....=========..&&~~~^~~~~~~~AAAA~~~~~~~AAAAAAAA^AA~~~~~~~~~AAAAAAAAA~~~~~~~AAAAAAAAAAAA^^A
===.~A*~~&.&.===========..&&~~A~~#~~~~~AA~~~~&~~~AAA~~AAAAAAA~~#~.~~~~~~~AAAA~~~~~~~~~AAAAAAAA^AAAAA
==..A~&.&&.&.===========..&&&~A~~~&&~~~~A~~~.&~~~~AA~~AAAAAAA~~~..~~~~~~~AAA~~~~~~~~~~AAAAAAAA^AAAAA
==..~~&.&&&..==.========..&&&.~~~~~&..~~~~~.&&&~~AAA~~AAAAAA~~~.~~~~&&~~AAAA~~~~...#~~~AAAAAAA^AAAAA
=..~&~+..&&&&.....=======..&&..~~~~&&&.~~...&&&.~^AA~~A^AAAA~~~.-~.&&&~~~~~~~~~..&&.~~~~AAAAAAAAAAAA
=.&~&~...&&..&&&....======..&&&~~~~&&&.~&&&&&&&&~AA~~~AA~AA~~~~&--.&&.~~~~..~&&&&&&&.~~~AAAAAAAAAAAA
=.~&&~~....&&&&~~.&..====...&&&&&~&&&&&~&&&&&&&.~~~~~~~~~~~~~~.&---.&.~~~.&&&&&&&&&&&~~~AAAAAAAAAAAA
=.&&..~.~~~...&~A~.&..==...&.&&&&~.&&&&&~&&&&&&.~~~~~~~~~~~~~&.-----&..~..&&&&&&&&&..~~AAAAAAAAA^AAA
==..=~~~~.~.+&&&~A~&.==......&&&&~~.&&&&&&&&&&&&#~&~~~~#~~~~~&&-----&&..&&&&&&&&&..~~~AA~AAAAAAA^AAA
======....~~...&~A&&.==..&..&&&&&&~~.&&&&&&&&&&&&&&-~.&&~~~&&&&-----.&&&&&&&&..~~~~~AA~~AAAAAAAAAAA~
=====..=...~~~&~~A~&~==..&&.&&&&&&&~.&&&&&&&&&&&.-----...&&&&~------.&&&&&&.~~~~~AAAAAAA~AAA~AAAAAA~
=========.&&&~~~A~~.~.==....&&&&&&&~&&&&&&&&&&&.--------.&&~~~-.---&&&&&&&.~~~~~A^~~AAA~~AAA~~AAAAA~
========..&.&&~AA~&.~+....&&&&&&&&&~&&&&&&&&&&&..---------~~&&.&...&&&&&&&.&.~~~^~~~~AA~~AA~~~AAA~AA
========.&&.&.~AA~&&~~..&&&&&&&&&&&~&&&&&&&&&&&&.----&&---..&&T&&&&&&&&&&&&&&.~~A~#~~A~~~AA~~~AAA~~~
========.&&&&~~^A~~&&~&&&&&&&&&&&&~~&&&&&&&&&&&&..---.&..&&&&&&&&&&&&&&&&&&&&&~~AA~T~~~~~AA~~~A^AAA~
=========.&&~~AAA~&.&~--&&&~~~&&~~~&&&&&&&&&&&&&&.~--.&&&&&&&&&&&&&&&&&&&&&&&&&..~~T~~~T~AA.~~A^A^A~
==========.&&&A~~&.------~~~T~~~~T~&&&&&&&&&&&&&&-~~-.&&&&&&&&&&&&&&&&&&&&&&&&&&.~~TT~TT~~~T~~AAAAA~
===========.&&~&&&-------TTT.TT.T~~&.&&&&&&&&&&~----&&&&&&&&&&&&&&&&&&&&&&&&&&.~~~~~TTT~~A~TT~~~~~~~
============..&&&~~---TT..TTTT..T~&&&&&&&&&&&&&~&--&&&&&&&&&&&&&&&&&&&&&&&&&&&~~~~~~TTT~~A~TT~~~..~~
====...======.&~~~TT---...T.TT...~&&&&&&&&&&&&&~&~.&&&&&&&&&&&&&&&&&&&&&&&&&&~~~~~~TT~~~AA~TT.~~.T.~
===.A~&.=..==~&~..T.TTT.TT...TT..~&..&&&&&&&&&.~&~.&&&&&&&&&&&&&&&&&&&&&&&&~~~TTT~TT~~~AA~~.TT~~~TT.
==.~~.......=~~~.T...T....T..T..T~..&&&&&&&&&&&~~~.&&&&&&&&&&&&&&&&&&&&&&&.~TTTT~TTTT~~^A~~.TT~~.TTT
==.&.+..T.T.....TTT.TTTTT..TT...T~~&.&&...&&&&&~..&.&&&&&&&&&&&&&&&&&&&&.~~~TTT~~TTTT~AA#~..T~~.TTTT
===.....TTTT.T..TTTTTTTTTTTTTTTT..~.&&&&&&&&.&~~~&&&&&&&&&&&&&&&&&&&&&~~~~~.TTTT~TTTT~A~.TTT.~~TTTTT
====...TTTTTTTTTTTTTTTTTTTTTTTTT.T~.&..&&&.&&~~.~~&.&&&&&&&&&&&&..&..~~TTTTTTTTT~TTTT.A~.TTTT..TTTT.
===..TTTTTTTTTTTTTTTTTTTTTTTTTTT.T~~~&..&..&~T...~~~&&&&&&&&&&.&&&&..~.TTTTTTTTTTTTTT.~.TTTTTTTTTT.T
==...TT.TT..TTTTTTTTTTTTT&TTTTTT..TT~&&&&.&&-TT.T.T~.&&&&&&&..&&&..-~~.T.TTTTTTTTTTTTT.TTTTTTTTTTT.T
=.T.T..TT.TTTTTTTTT.TTTTTTTTTTTTT.TT-..&&&&--..TTT.~.&...&&&&&&&&.---~.TTTTTTTTTTTTTTTTTTTTTTTTTTTTT
=....T..T.TTTTTTTT.TTTTTTTTTTTTTTTT---&--&---..TTTT~~~.&&&&..&&&...----..TT..T&TTTTTTTTTTTTTTT..TTTT
=...TT.T.TTTTTTTTT.TTTTTTTTTTTTTTTT---------+..T.TTT.~~~&...&.&.....---..TTTTTTTTTTTTTTTTTTTTT.T.TTT
==.TTTT.TTTTTTTTT.TTTTTTTTTTTTTTTTTT-T------..TTTTTT.TT~~~~.&....+..----...TTTTTTTTTTTTTTTTTTTTTTTTT
==.T..T..TTTT.T.T..TTTTTTTTTTTTTTT.TTTT----...TTTT...TTT.T~~~......------...TTTTTTTTTTTTTTTTTTTTTT..
===.TT..T...TTTTT....TTTTTTTTTTTTTT.TTTT---T..T.TTTTTTTTTTTT~~..----------TT.TTTTTTTTTTTTTTTTTTTT...
====.........TTTTT..TTT.TTT.TTTTTT.TTTTT.-TTTTTTTTTTTTTTTTTT~-------------..TTTTTT~TTTTTTTTTTTTT..~~
====.TTTT.T.T.T....TTT..TTTT.TTT.TTTTTT..TTTTTTT.TTTTTTTTTT.--------..~---.TT.TT~~~~TTTTTTT&TTT..~~~
===..TT..T......==TT.TT.TTTT.TTTT..T.TT.TT.T.TTTTTTTTTTTTTT.-------...~~--T.TTTTTT~~~~TTTTTTTTT..~AA
==.TT........======T..TT.T..TT.TTT.T...T.TT.TTTTTTT&TTTTTT..-----..+..-~...TTT..TT~T~~~TT.TT...~AAA^
==...T.+...========.....TTT.TT..TT.TTTTTTTTT.TTTTTTTTTTTTT~~----~....---..TTTT..TT~TT~~~T..T...AAA^^
===........========....T.TT.TTTTTTTTTTTTTT.TTTTTTTTTTTTTTT~..--~~--.----~.TTT.TT~~~...~~TTT~~~~~AAAA
=======...==..====....TT..TTTTTTTTTTTT.TTT.TTT.TTTTTTTTTT~~.....T.-----~~~TT--T.~.o....~~~~~~AAAAAAA
===...====......+......TT..TT.TT.TTTTTTT.T.T~~T.TTT.TTTTT~T~..TTTT.----..~----~~~...T..~AA~~AAAAAAA~
==.&A&.==...........T.T...T......TTTTTTTT.TTATT.TTTT..TTT~T~~T.TTTT--....-----......T..~~AAA^AAA~~~~
==.~&..=...T........TTTTTTTTTT.TT.T.TTTTTTTTA~..TTTTTT..~~TT~~.TT.T...T..------..TTT..~~~A^^AA~~o~~~
===.....TTTT.T......T...T.T..TTTTTTTTTTT..T~A~..T.T.....~..T.~~~TTTTTTT..------~..TT.~~~AAAAA~~~~~~~
=====.T.TTTT..T.TTTT..*..TT.TTTTTTTT.TTTTT.AA..T..T.....=....TA~TT.TTT....----.~....~~~AA^^~~~~~~~~~
=====..=T.T...TTT.TT....TTTTTT...TTTTTTT.T.~A..=...=.+..==....A~TTTTTTT.o..--..~~~~AAAAA^^~~~~~~~~~~
====.=.=..T.*...TT.....TT.TTTTT.....TT.TTT.A^.=======..====..TA^~~T.TTT.....T..~~~AAA^AA~~~~~~~~~~~~
========..T=.....TTT.TTTTTT...T..=...T...T~^~.============...~A^T~TTT..T......~~~AA^AAA~~~~~~~~~~~~~
=====......===...T..TTTT.........==...TTT.A~..T.=========...TT~A^T~TT.TTTTTTT~~AAAAAA~A~~~~~~~~~~~~~
======.......==..T..T.TT.........===...T..A~..T..========...~~A~AA~~.TTTT.TT~~AAAAAAAAA~~~~o~~~~~~~~
=====..&&....=..T.....TT.......=====.=...~~~~.T.T==..====...~~~~TAA~~...T..~~~^^^~AAAAA~~~~~~~~~~~~~
====.&&&~~..==..TT..*.T...+....======.T~~.~T~~T.....==.===.......~A~TTT~~~~~~A^~~~~~~A~A~~~~~~~~~~~~
====.&~AA&&.==.TT.==..T..T....======..T~TTT...~.TT..=..====.......~~T~~AAA~AAA~~~~~~~~~~A~~~~~~~~~~~
====...~&&.==..TT.==..TTT.....====....T.....TT.TT.......=======...~~~~AA^AAA~~~~~~~~~~~~~~~~~~~~~~~~
=====...&&.==.....==.T..T....=====....T......TTTTT.T.TT..======...~~~AAAAAA~~~~~~~o~~~~~~~~~~~~~~~~~
=====.....====...==........TT.===..==....=....T.T..TTTT....=====.~~~~~~AAA~~~~~~~~~~~~~~~~~~~~~~~~~~
======..=======.===...==...=..======...===+....T.TTTTT...=..=====~~~~oAA~~~~~~~~~~~~~~~~~~~~~~~~~~~~
========================...=....===....====......TTT.T.T==========~~~~~~~~~~~~~~~~~~~~~~~~~~~~~~~~~~
========================..====..===...======.TTT...TTT.T==========~~~~~~~~~~~~~~~~~~~~~~~~~~~~~~~~~~
====================================.=======.TT.......T.T========~~~~~~~~~~~~~~~~~~~~~~~~~~~~~~~~~~~
============================================....=======..=======~~~~~~~~~~~~~~~~~~~~~~~~~~~~~~~~~~~~
===========================================...=================~~~~~~~~~~~~~~~~~~~~~~~~~~~~~~~~~~~~~
===============================================================~~~~~~~~~~~~~~~~~~~~~~~~~~~~~~~~~~~~~
============================================================~~~~~~~~~~~~~~~~~~~~~~~~~~~~~~~~~~~~~~~~