  ##            #      # 
 ##     ####    ##    # #
 ##### ## ##    ##   ### 
 ########### # ###   ####
 ############ ####    ###
###########   ###### ####
 ########################
##############   ##### ##
###########       #######
### # #####        ######
