=================.~~~~AAAAAA^^AAAAAAAA^^^^^AAAAAAAA^^^^^^^^^^^AAAAAAAAA^^^^A^^^AAAAAAAAAA^^^^^^^^^^^
======.==========..~~~~~AAAAAAAAAAAAAAA^^AAAAAAAAAAAA^^^^^AAAAAAAAAAAAAAAA^^^AAAAAAAAAAAAAA^^^^^^^^^
=====.T.==========...~~~~AAAAAAAAAAAAAAAAAAAAAAAAAAAAAA^^AAAAAAAAAAAAAAAA^^^AAAAAAAAAAAAAAAAA^^^^^AA
=====.AT.=========.....~~~AAAAAAAAAAAAAAAAAAAAAAAAAAAAAAAAAAAAAAAAAAAAAAAAAAAAAAAAAAAAAAAAAAAAA^^^^A
====.TAA.==========.....T.~~~AA~~~AAAAAAAAAA~~~~AAAAAAAAAAAAAAA~~A~AAAAAAAAAAAAAAAAAAAAAAAAAAAAA^^^A
===.TT^~T.=============..TT~A^A~~~~AAAAAAAA~~~~~~AAAAAAAAAAA~~~~~~~~AAAAAAAAAAAAAAAAAAAAAAAAAAAAA^^A
===.T^^A~T.============..TT~~~^~~~~~~~AAAA~~~~~~~AAAAAAAA^AA~~~~~~~~~AAAAAAAAA~~~~~~~AAAAAAAAAAAA^^A
===.~A*~~T.=============..TT~~A~~#~~~~~AA~~~~T~~~AAA~~AAAAAAA~~#~.~~~~~~~AAAA~~~~~~~~~AAAAAAAA^AAAAA
==..A~T...==============..TTT~A~~~TT~~~~A~~~.T~~~~AA~~AAAAAAA~~~..~~~~~~~AAA~~~~~~~~~~AAAAAAAA^AAAAA
==..~TTX=======.========..TTT.~~~~~T..~~~~~.TTT~~AAA~~AAAAAA~~~.~~~~TT~~AAAA~~~~...#~~~AAAAAAA^AAAAA
=..~TT+X=====.....=======..TT..~~~~TTT.~~...TTT.~^AA~~A^AAAA~~~.-~.TTT~~~~~~~~~..TT.~~~~AAAAAAAAAAAA
=.T~TTX=====..TT....======..TTT~~~~TTT.~TTTTTTTT~AA~~~AA~AA~~~~T--.TT.~~~~..~TTTTTTT.~~~AAAAAAAAAAAA
=.~TT..=====.TT~~.T..====...TTTTT~TTTTT~TTTTTTT.~~~~~~~~~~~~~~.T---.T.~~~.TTTTTTTTTTT~~~AAAAAAAAAAAA
=.TT..======XXT~A~.T..==...T.TTTT~.TTTTT~TTTTTT.~~~~~~~~~~~~~T.-----T..~..TTTTTTTTT..~~AAAAAAAAA^AAA
==..=======X+TTT~A~T.==......TTTT~~.TTTTTTTTTTTT#~T~~~~#~~~~~TT-----TT..TTTTTTTTT..~~~AA~AAAAAAA^AAA
===========....T~ATT.==..T..TTTTTT~~.TTTTTTTTTTTTTT-~.TT~~~TTTT-----.TTTTTTTT..~~~~~AA~~AAAAAAAAAAA~
==========.T.TT~~A~T~==..TT.TTTTTTT~.TTTTTTTTTTT.-----...TTTT~------.TTTTTT.~~~~~AAAAAAA~AAA~AAAAAA~
=========.TTTT.~A~~.~X==....TTTTTTT~TTTTTTTTTTT.--------.TT~~~-.---TTTTTTT.~~~~~A^~~AAA~~AAA~~AAAAA~
========..T.TT~AA~T.~+XX..TTTTT&TTT~TTTTTTTTTTT..---------~~TT.T...TTTTTTT.T.~~~^~~~~AA~~AA~~~AAA~AA
========.TT.T.~AA~TT~~..TTTTTTTTTTT~TTTTTTTTTTTT.----TT---..TTTTTTTTTTTTTTTTT.~~A~#~~A~~~AA~~~AAA~~~
========.TTTT~~^A~~TT~TTTTTTTTTTTT~~TTTTT&TTTTTT..---.T..TTTTTTTTTTTTTTTTTTTTT~~AA~T~~~~~AA~~~A^AAA~
=========.TT~~AAA~T.T~--TTT~~~TT~~~TTTTTTTTTTTTTT.~--.TTTTTTTTTTTTTTTTTTTTTTTTT..~~T~~~T~AA.~~A^A^A~
==========.TTTA~~T.------~~~T~~~~T~TTTTTTTTTTTTTT-~~-.TTTTTTTTTTTTTTT&TTTTTTTTTT.~~TT~TT~~~T~~AAAAA~
===========.TT~TTT-------TTT.TT.T~~T.TTTTTTTTTT~----TTTTTTTTTTTTTTTTTTTTTTTTTT.~~~~~TTT~~A~TT~~~~~~~
============..TTT~~---TT..TTTT..T~TTTTTTTTTTTTT~T--TTTTTTTTTTTTTTTTTTTTTTTTTTT~~~~~~TTT~~A~TT~~~..~~
====...======.T~~~TT---...T.TT...~TTTTTTTTTTTTT~T~.TTTTTTTTTTTTTTTTTTTTTTTTTT~~~~~~TT~~~AA~TT.~~.T.~
===.A~T.=====~T~..T.TTT.TT...TT..~T..TTTTTTTTT.~T~.TTTTTTT&TTTTTTTTTTTTTTTT~~~TTT~TT~~~AA~~.TT~~~TT.
==.~~XX.=====~~~.T...T....T..T..T~..TTTTTTTTTTT~~~.TTTTTTTTTTTTTTTTTTTTTTT.~TTTT~TTTT~~^A~~.TT~~.TTT
==.T.+X=====....TTT.TTTTT..TT...T~~T.TT...TTTTT~..T.TTTTTTTTTTTTTTTTTTTT.~~~TTT~~TTTT~AA#~..T~~.TTTT
===.XX====......TTTTTTTTTTTTTTTT..~.TTTTTTTT.T~~~TTTTTTTTTTTTTTTTTTTTT~~~~~.TTTT~TTTT~A~.TTT.~~TTTTT
=========.TTTTTTTTTTTTTTTTTTTTTT.T~.T..TTT.TT~~.~~T.TTTTTTTTTTTT..T..~~TTTTTTTTT~TTTT.A~.TTTT..TTTT.
===..==..TT..TTTTTTTTTTTTTTTTTTT.T~~~T..T..T~T...~~~TTTTTTTTTT.TTTT..~.TTTTTTTTTTTTTT.~.TTTTTTTTTT.T
==...TT..T..TTTTTTTTTTTTT&TTTTTT..TT~TTTT.TT-TT.T.T~.TTTTTTT..TTT..-~~.T.TTTTTTTTTTTTT.TTTTTTTTTTT.T
=.T....TT.TTTTTTTTT.TTTTTTTTTTTTT.TT-..TTTT--..TTT.~.T...TTTTTTTT.---~.TTTTTTTTTTTTTTTTTTTTTTTTTTTTT
=....T..T.TTTTTTTT.TTTTTTTTTTTTTTTT---T--T---X.TTTT~~~.TTTT..TTT...----..TT..T&TTTTTTTTTTTTTTT..TTTT
=...TT.T.TTTTTTTTT.TTTTTTTTTTTTTTTT---------+X.T.TTT.~~~T...T.T...XX---..TTTTTTTTTTTTTTTTTTTTT.T.TTT
==.TTTT.TTTTTTTTT.TTTTTTTTTTTTTTTTTT-T------X.TTTTTT.TT~~~~.T....+XX----...TTTTTTTTTTTTTTTTTTTTTTTTT
==.T..T..TTTT.T.T..TTTTTTTTTTTTTTT.TTTT----...TTTT...TTT.T~~~...XXX------...TTTTTTTTTTTTTTTTTTTTTT..
===.TT..T...TTTTT....TTTTTTTTTTTTTT.TTTT---T..T.TTTTTTTTTTTT~~..----------TT.TTTTTTTTTTTTTTTTTTTT...
====.........TTTTT..TTT.TTT.TTTTTT.TTTTT.-TTTTTTTTTTTTTTTTTT~-------------..TTTTTT~TTTTTTTTTTTTT..~~
====.TTTT.T.T.T....TTT..TTTT.TTT.TTTTTT..TTTTTTT.TTTTTTTTTT.--------XX~---.TT.TT~~~~TTTTTTT&TTT..~~~
===..TT..T......==TT.TT.TTTT.TTTT..T.TT.TT.T.TTTTTTTTTTTTTT.-------XXX~~--T.TTTTTT~~~~TTTTTTTTT..~AA
==.TT..XX....======T..TT.T..TT.TTT.T...T.TT.TTTTTTT&TTTTTT..-----XX+XX-~...TTT..TT~T~~~TT.TT...~AAA^
==...TX+X..========.....TTT.TT..TT.TTTTTTTTT.TTTTTTTTTTTTT~~----~XXXX---..TTTT..TT~TT~~~T..T...AAA^^
===....X...========....T.TT.TTTTTTTTTTTTTT.TTTTTTTTTTTTTTT~..--~~--X----~.TTT.TT~~~...~~TTT~~~~~AAAA
=======...==..====X...TT..TTTTTTTTTTTT.TTT.TTT.TTTTTTTTTT~~.....T.-----~~~TT--T.~Xo....~~~~~~AAAAAAA
===...====....XX+XX....TT..TT.TT.TTTTTTT.T.T~~T.TTT.TTTTT~T~..TTTT.----..~----~~~...T..~AA~~AAAAAAA~
==.TAT.==......XX.....T...T......TTTTTTTT.TTATT.TTTT..TTT~T~~T.TTTT--....-----......T..~~AAA^AAA~~~~
==.~T.==.............TTTTTTTTT.TT.T.TTTTTTTTA~..TTTTTT..~~TT~~.TT.T...T..------..TTT..~~~A^^AA~~o~~~
===..==.............T...T.T..TTTTTTTTTTT..T~A~..T.T.....~..T.~~~TTTTTTT.X------~..TT.~~~AAAAA~~~~~~~
=======...............*..TT.TTTTTTT..TTTTT.AA..T..T..X..=....TA~TT.TTT..XX----.~....~~~AA^^~~~~~~~~~
========................TTTTTT........TT.T.~A..=...=X+XX==....A~TTTTTTT.oXX--..~~~~AAAAA^^~~~~~~~~~~
========....*...........T.TTTTT.....TT.TTT.A^.=======XX====..TA^~~T.TTT.....T..~~~AAA^AA~~~~~~~~~~~~
=========..=.............TT...T..=...T...T~^~.============...~A^T~TTT..T......~~~AA^AAA~~~~~~~~~~~~~
=======.======...................==...TTT.A~..T.=========...TT~A^T~TT.TTTTTTT~~AAAAAA~A~~~~~~~~~~~~~
======......===..................===...T..A~..T..========...~~A~AA~~.TTTT.TT~~AAAAAAAAA~~~~o~~~~~~~~
=====..TT....=............XX...=====.=...~~~~.T.T==..====...~~~~TAA~~...T..~~~^^^~AAAAA~~~~~~~~~~~~~
====.TTT~~..==......*....X+XX..======.T~~.~T~~T.....==.===.......~A~TTT~~~~~~A^~~~~~~A~A~~~~~~~~~~~~
====.T~AATT.==....==.....TXX..======..T~TTT...~.TT..=..====.......~~T~~AAA~AAA~~~~~~~~~~A~~~~~~~~~~~
====...~TT.==.....==.......X..====....T.....TT.TT.......=======...~~~~AA^AAA~~~~~~~~~~~~~~~~~~~~~~~~
=====...TT.==.....==.........=====....T......TTTTT.......======...~~~AAAAAA~~~~~~~o~~~~~~~~~~~~~~~~~
=====.....====...==........TT.===..==....=XX..T.T..........=====.~~~~~~AAA~~~~~~~~~~~~~~~~~~~~~~~~~~
======..=======.===...==...=..======...===+X...T.........=..=====~~~~oAA~~~~~~~~~~~~~~~~~~~~~~~~~~~~
========================...=....===....====X...........T==========~~~~~~~~~~~~~~~~~~~~~~~~~~~~~~~~~~
========================..====..===...======.TTT.......T==========~~~~~~~~~~~~~~~~~~~~~~~~~~~~~~~~~~
====================================.=======.TT.......T.T========~~~~~~~~~~~~~~~~~~~~~~~~~~~~~~~~~~~
============================================....=======..=======~~~~~~~~~~~~~~~~~~~~~~~~~~~~~~~~~~~~
===========================================...=================~~~~~~~~~~~~~~~~~~~~~~~~~~~~~~~~~~~~~
===============================================================~~~~~~~~~~~~~~~~~~~~~~~~~~~~~~~~~~~~~
============================================================~~~~~~~~~~~~~~~~~~~~~~~~~~~~~~~~~~~~~~~~