   ###########         # #   ####       ##     ############                     
   ### # #### #         ##  #####      ###   ################                   
 #  ##### ####          ### ##  #   # ####    #   ## #########                  
 ###  #####             ###  ## ###########         ######## #      #           
### # #####              ## ########  #####         ###### ###     # #          
###########            #############  ##           # ##### ###   #######        
############      #    ############ # #          # ########### ##### ####       
#############  #######  ######  # ####        ########## ### ##  ### ####       
############## ############## # ####        ########### #      ##########       
############### ####  ######## # ###       ################    #########        
########################### ## # ###   #  ##################  #### #####        
########## ####  ########### ######### ####### #################  #######       
########## ####  ####### #############  ##### #### ##########      #######      
############  ############## ######### ###### ################       ###        
############ ##### ## ###   ###### ################ ##########          ###     
############ #########       #### ## # ############ #########            ###    
########### ####### ###       ####     ########################         #####   
### #############  ####        ##    ###### ####    # ###  ####        #        
########### ##    ## ##              ### ## ####   #  ##   #####      ####      
# ###########        ##  #              ######### #### ## # ### #### ## ##      
########## #         ### ###            #### ##### ###   ### ### #####          
 ###   #####         ######               #### #  ####  ###  # ##### #          
  ########            #####               ## ### ## #### ####  #####            
  ## ## ###            ####               ####  ######     #                    
  ######## #          #####   #             #  #####  #    # ##                 
 ##########       #   #####  ##              ##   #   ###  ###                  
#############     ##  #### ####              #    #   #### # #                  
##################  ####### ###   ##   ###       #     #######                  
##  ######################  # #   ## #####     ####   #######   #               
   ############## ###########  #  ########     ## ##  # ###### ### ##           
    ########## ### ########### ## ### ######   ####  ################         ##
     ################ ######## ########### ## #######################       ####
       ############## ########## ###### ############################        # ##
      # ####################### ########### ##########################      ### 
      ### ### ################# ######################################       ## 
      ## ###  #####################   ## ##### ###########################  ##  
     #  ######## ##################  #########  ##########################  ##  
      ##  ## ##  ### ###### #################### ################## ##########  
           ##    # ########### ################   ####################### ######
                  # ######### ######## # ############################   # ######
                   ##########      ####   ######################  ##    ########
                    ### #####     #    #  ######################  #     ########
                    # ## ####      #    ######################## ####   ########
                    ##     #        ## ###############################  ########
                    ###    ##        ################################# #########
                   ###     ####    ######################################### ###
             ### ###  #   #####     ############################################
             ####  #  #  #####      ############################################
             ## ## ## ### ## ##      #### ########################### ### ######
             ##  ######## # ###          #######################################
