#########   #   #######                                                         
##########  ## ########                                                         
####### ##### # # #####                                                         
#### ########## # #  # #                                                        
#### ##############  ###                                                        
################### ###                                #                        
##################  ####                             ####                       
 ######## ###### # ####                               ####                      
############ ######### #                              #####                     
###### ##  ############                ##            ######                     
###################  ###          ##  #######         ##  ##                    
### ###############  ###          #### ########      ## ####   ##               
####################              ###  #########     ##  ##### ####             
####################              ##### ########    ##  ###########             
################# ###            #################  #   ##########              
######################          ### ############### ##  #  ##### ##             
#######################          # ##   #############  ### #######              
####################  ##           ### ############## ### ##########            
##################   # #  #  #   ################################# ##           
####################  ### #### # ################################## ## # #      
 ######################################### #######################    # # ##    
    ###############################################################       #     
      #######################################    ############### #      ###     
     #######################################     ##################      ###    
     #################################### ###   #### #####   #####       ####   
  ### ######################################## ####### ####           # ## #    
  ##    ######################## ############## ###########        #########    
  ###  ###################################### ##############        ####  #     
  ##   ###################################### ######## #####         #   # #    
  ### ################################ ########### ###   ##              ##     
   ####################################  #######    ### # ##                    
    ########################### #############   ##   #######                    
    ##### #### ########################### ##   ###   ### #                     
 ########## ############################     # ############                     
############################### ##### #    ############# ##                     
####### # #####################  ##### ### #  ##### ########                    
### #### ##################################   ########### #                     
## ###    ################## ########  #####  ### ###########                   
 ######   ##############   #  #####  ### ################## ##                  
  ####### ############## #    ### # ######  ### # #########  ####               
  ####################### #    ### ########  ####################               
## ########################     ######### ## ### ########  ######    ####       
#############################  ########## ################# ###### ### ##       
####### ################################################## ####### ##  #        
###  #  ###  ############################ ###############   ######   # ##       
 #       ############### #################  ##############  ######  ####        
        #################################################### #############      
         ## ############################################## #  ############      
           ##################### ###########  ##############    ##########      
            ############# #################   ##############     ##########     
